# Avida tasks data
# Wed Apr 12 11:17:19 2023
# First column gives the current update, next columns give the number
# of organisms that have the particular task as a component of their merit
#  1: Update
#  2: Not
#  3: Nand
#  4: And
#  5: OrNot
#  6: Or
#  7: AndNot
#  8: Nor
#  9: Xor
# 10: Equals

0 0 0 0 0 0 0 0 0 0 
100 0 0 0 0 0 0 0 0 0 
200 0 0 0 0 0 0 0 0 0 
300 0 0 0 0 0 0 0 0 0 
400 0 0 0 0 0 0 0 0 0 
500 0 0 0 0 0 0 0 0 0 
600 0 0 0 0 0 0 0 0 0 
700 15 0 0 0 0 0 0 0 0 
800 151 6 0 0 0 0 0 0 0 
900 477 152 0 54 0 0 0 0 0 
1000 1138 457 0 379 0 0 0 0 0 
1100 1890 670 2 1145 0 0 0 0 0 
1200 3171 447 0 2373 1971 0 0 0 0 
1300 4425 325 0 3902 3749 0 0 0 0 
1400 5832 299 0 5523 5401 16 0 0 0 
1500 6884 369 0 6768 6627 1563 0 0 0 
1600 7855 499 146 7820 7767 3152 0 0 0 
1700 8519 623 1143 8580 8458 4249 0 0 0 
1800 9018 946 2318 9093 8934 5225 2 0 0 
1900 9422 1997 3335 9521 9397 5918 0 0 0 
2000 9710 3402 4394 9919 9686 6738 0 0 0 
2100 10008 4625 5332 10246 9993 7622 2 0 0 
2200 10159 5655 6092 10394 10064 8499 0 0 0 
2300 10473 6720 6931 10674 10387 9317 2 0 0 
2400 10617 7640 7649 10852 10592 9894 19 0 0 
